        #
    #########
   ##       ##
   #    #    #
 ###  #####  ###
 #@   #   #    #
 #  ###   ###$ #
 #  #       #  #
## ##       ## ##
 #  #       #  #
 #  ###   ###  #
 #    #   #   .#
 ###  #####  ###
   #    #    #
   ##       ##
    #### ####
       # #
       ###
        #