          #
         ###
         # #
      #### ####
     ##       ##
     #    #  . #
   ###  #####  ###
   #@   #   #    #
   #  ###   ###  #
 ###  #       #  ###
##   ##       ##   ##
 ###  #       #  ###
   #  ###   ###  #
   #  $ #   #   .#
   ###  #####  ###
     #  . #$   #
     ##       ##
      #### ####
         #$#
         ###
          #
