          #
         ###
         # #
      #### ####
     ##       ##
     #    #  . #
   ###  #####  ###
   #@   #   #    #
   #  ###   ###$ #
 ###  #       #  ###
##   ##       ##   ##
 ###  #       #  ###
   #  ###   ###  #
   #    #   #   .#
   ###$ #####  ###
     #  . # $  #
     ##       ##
      #### ####
         # #
         ###
          #
; 1
