    #####
    #   #
    #   #
  ###   ##
  #      #
### # ## #   #####
#   # ## #####   #
#               $.#
##### ### #@##   #
    #     ########
    #######
; 1
