    #####
    #   #
    #   #
  ###   ##
  #      #
### # ## #   ######
#   # ## #####   #
#    $           .#
##### ### #@##   #
    #     #########
    #######
; 1
