    #####
    #   #
    #   #
  ###   ##
  #      #
### # ## #   ####
#   # ## #####   #
#    $           .#
##### ### #@##   #
    #     #######
    #######
; 1

############
#..  #     ###
#..  # $  $  #
#..  #$####  #
#..    @ ##  #
#..  # #  $ ##
###### ##$ $ #
  # $  $ $ $ #
  #    #     #
  ############
; 2
